@2131121112112212222
1SaE000a00aa000a0p01
10S0a0ppcc0002121202
12aS000a010000002p02
1020Ss00000000002p01
10114S00112312112012
12ssssS0000000004p02
100000pSppp000444002
10000000S0000a02ss03
300004444S0000a22002
1000222200S00002s221
120000ccc00S00020001
100000444400S4444c02
2ccc00ppp4040S022001
12122221131212222112