@2131121112112212222
10a0000a00aa0S0a0p01
1040aSppcc0002121202
12a0000a0S0000002p02
1020ssS0000000002p01
10114000112312112012
12ssss000S0000004p02
100000ppppp000444002
10S00000S0000a02ss03
300S0444440000a22002
1000222200000002s221
120000ccc00000020001
10000044440444444c02
2ccc00ppp4040S022001
12122221131212222112