@2131121112112212222
10a0000a00aa000a0p01
1040aappcc0002121202
12a0000a000000002p02
1020ss00000000002p01
10114000112312112012
12ssss00000000004p02
100000ppppp000444002
1000000000000a02ss03
30000444440000a22002
1000222200000002s221
120000ccc00000020001
10000044440444444c02
2ccc00ppp40400022001
12122221131212222112