@2131121112112212222
10a0000a00aa000a0001
10400000000021212002
12a0000a000000002002
10200000000000002001
10114000112312114001
12000000000000004002
10000000000000444002
1000000000000a022003
30000444440000a00002
10002222000000000001
12000000000000000001
10000044440444444002
20000000040400000001
12122221131212222112